##########################
# #S#            #   #   #
# # # # ###### # # # # # #   
# # # # #      #   #   # #  
# # # # ################ #                  
# # ### #                #    
# #   # #  # ###### ######              
# # # # #  # #    # #    #    
# # # # #  # # #### # ####     
# # #      # #           #                 
# # ######## ######### ###                    
#                        #
##########################